{
	"name":    "test1",
	"gps":     [0, 0, 0],
	"size":    [15, 8],
	"adjacentRooms": [
		false,
		"test3",
		false,
		false,
		false,
		false,
		"test2",
		false
	],
	"terrain": [
		[0, 0, 0, 0, 0, 0, 1, 0],
		[0, 3, 2, 2, 1, 0, 0, 0],
		[0, 3, 2, 1, 0, 0, 0, 4],
		[0, 3, 2, 1, 0, 0, 0, 4],
		[0, 3, 2, 1, 0, 0, 0, 0],
		[0, 3, 2, 2, 1, 0, 0, 0],
		[0, 0, 0, 0, 0, 0, 0, 0],
		[1, 0, 0, 0, 0, 0, 0, 0],
		[1, 0, 0, 0, 0, 0, 0, 0],
		[0, 0, 1, 1, 1, 1, 1, 0],
		[0, 0, 1, 2, 2, 2, 1, 0],
		[0, 0, 1, 2, 3, 2, 1, 0],
		[0, 0, 1, 2, 2, 2, 1, 0],
		[0, 0, 1, 1, 1, 1, 1, 0],
		[0, 0, 0, 3, 3, 3, 0, 0]
	]
}